%%%%%%%%%%%%%%%%%%%%%%%%%%%%%%%%%%%%%
% P.................................%
% . %%%%%%%%%%%%%%%%%%%%%%%%%%%%%%% %
% .                              .% %
% . %%%%%%%%%%%%%%%%%%%%%%%%%%%%% % %
% .                          .    % %
% . %%%%%%%%%%%%%%%%%%%%%%%%%     % %
% . .                             % %
% . %%%%%%%%%%%%%%%%%%%%%%%%%     % %
% .                         .     % %
% . %%%%%%%%%%%%%%%%%%%%%  .      % %
% . %%%%%%%%%%%%%%%%%%%%  .       % %
% . %%%%%%%%%%%%%%%%%%%  .        % %
% . %%%%%%%%%%%%%%%%%   .         % %
% .                         .     % %
% . %%%%%%%%%%%%%%%%%%%%%%%%%%%%% % %
% . . %%%%%%%%%%%%%%%%%%%%%%%%%%% % %
% .  . %%%%%%%%%%%%%%%%%%%%%%%%%% % %
% .   .                           % %
% .    .                          % %
% .  %%   %%          %%   %%     % %
% .  %%   %%          %%   %%     % %
% .  %%   %%          %%   %%     % %
% .     ..               .        % %
% .     ..               .        % %
% . %%     %%                     % %
% . %%%%%%%%%         %%%%%%%%%   % %
% .                   %%  .  %%   % %
% .                      . .      % %
% .                       .       % %
% .                               % %
% .                               % %
% .                               % %
% .                               % %
% .              F                % %
% .                                .%
%%%%%%%%%%%%%%%%%%%%%%%%%%%%%%%%%%%%%