%%%%%%%%%%%%%%%%%%%%%%%%%%%%%%%%%%%%%
% P                                .%
% . %%%%%%%%%%%%%%%%%%%%%%%%%%%%%%% %
%                                .% %
%   %%%%%%%%%%%%%%%%%%%%%%%%%%%%% % %
%                            .    % %
%   %%%%%%%%%%%%%%%%%%%%%%%%%     % %
%   .                             % %
%   %%%%%%%%%%%%%%%%%%%%%%%%%     % %
%                                 % %
%   %%%%%%%%%%%%%%%%%%%%%         % %
%   %%%%%%%%%%%%%%%%%%%%          % %
%   %%%%%%%%%%%%%%%%%%%  .        % %
%   %%%%%%%%%%%%%%%%%             % %
%                                 % %
%   %%%%%%%%%%%%%%%%%%%%%%%%%%%%% % %
%   . %%%%%%%%%%%%%%%%%%%%%%%%%%% % %
%      %%%%%%%%%%%%%%%%%%%%%%%%%% % %
%                                 % %
%                                 % %
%    %%   %%          %%   %%     % %
%    %%   %%          %%   %%     % %
%    %%   %%          %%   %%     % %
%                                 % %
%                        .        % %
%   %%     %%                     % %
%   %%%%%%%%%         %%%%%%%%%   % %
%                     %%     %%   % %
%               .                 % %
%                                 % %
%                                 % %
%                                 % %
%                                 % %
%                                 % %
%                F                % %
%                                  .%
%%%%%%%%%%%%%%%%%%%%%%%%%%%%%%%%%%%%%