%%%%%%%%%%%%%%%%%%%%
%..................%
%..................%
%F.......P.........%
%..................%
%..................%
%%%%%%%%%%%%%%%%%%%%
