%%%%%%%%%%%%%%%%%%%%%%%%%%%%%%%%%
%..........G....................%
%..%%%.%.....%.%%%%%%%.%%%%%%%..%
%...%..%.....%.%.....%....%.....%
%...%G.%.....%.%......G...%.....%
%...%..%.....%.%%%%%%%....%.....%
%...%..%.....%.......%....%.....%
%...%..%.....%.%.....%....%.....%
%..%%%.%%%%%%%.%%%%%%%....%.....%
%...............P...............%
%%%%%%%%%%%%%%%%%%%%%%%%%%%%%%%%%