%%%%%%%%%%%%%%%%%%%%%%%%%%%%%%%%%%%%
%P                               . %
%.%%%%%%%%%%%%%%%%%%% %%% %%%%%%%% %
% %%   %   %      %%% %%%   %%     %
% %% % % % % %%%% %%%%%%%%% %% %%% %
% %% % % % % %    %%     %% %%     %
% %% % % % % % %%%%  %%%    %%%%%% %
% %  % % %   %    %% %%%%%%%%      %
% %% % % %%%%%%%% %%        %% %%% %
% %% %   %%       %%%%%%%%% %%     %
%    %%%%%% %%%%%%%      %% %%%%%% %
%  %%%      %       %%%% %% %      %
%      %%%%%% %%%%% %    %% %% %%% %
% %%%%%%      %F      %%%%% %%     %
%   .    %%%%%% %%%%%%%%%%  %%  %% %
%                           %%%%%% %
%  .       %%%%%%%%%%%%%%%         %
%%%%%%%%%%%%%%%%%%%%%%%%%%%%%%%%%%%%