%%%%%%%%%%%%%%%%%%%%
%                  %
%       ...        %
%F      .P.        %
%       ...        %
%           .      %
%%%%%%%%%%%%%%%%%%%%
