%%%%%%%%%%%%%%%%%%%%
%%     %%%%%%%%%%%%%
P  %%% %%%%     %%%%
%%%%%% %%%   %% %%%%
%%%        % %% %%%%
%%%  %%%% %% %% %%%%
%%%  %%%% %  %% %%%%
%%% %%%%% %%%%  %%%%
%%% %%%%% %%%   %%%%
%%% %%%%% %%%%   %%%
%%% % %%% %%%% %%%%%
%%%   %%%%%%%% %%%%%
%%%%% %%%%%%%%   %%%
%% %  %%% %%%%%% %%%
%% % %%    %%%%% %%%
%%%% %% %%%%%%%%   %
%       %%%%%%%% % %
%%%%%%%%%%%%%%%%  F%
%%%%%%%%%%%%%%%%%%%%