%%%%%%%
%    P%
% %%% %
%  %  %
%%   %%
%F %%%%
%%%%%%%
