%%%%%%%%%%%%%%%%%%%%%%%%%%%%%%%%%%%%
%                                 F%
% %%%%%%%%%%%%%%%%%%%%%%% %%%%%%%% %
% %%   %   %      %%%%%%%   %%     %
% %% % % % % %%%% %%%%%%%%% %% %%%%%
% %% % % % %      %%%%%%%%% %%     %
% %% % % % % % %%%%  %%%    %%%%%% %
% %  % % %   %    %% %%%%%% %      %
% %% % % %%%%%%%% %%        %%%%%%%%
% %% %   %%       %%%%%%%%% %%     %
%    %%%%%% %%%%%%%      %% %%%%%% %
%%%%%%      %       %%%%    %P     %
%      %%%%%% %%%%% %    %% %% %%%%%
% %%%%%%      %       %%%%% %%     %
%        %%%%%% %%%%%%%%%%% %%  %%%%
%%%%%%%%%%                % %%%%   %
%          %%%%%%%%%%%%%%%%    %   %
%%%%%%%%%%%%%%%%%%%%%%%%%%%%%%%%%%%%