%%%%%%%%%%%%%%%%%%%%%%%%%%%%%%%%%%%%%%%%
%P                     %               %
% %%%%% %%%%%%%%%%%%%%%%               %
% %   % %%%%%%%%%%%%%%%% %%%%%%%%%%%%% %
%%% % %                                %
% % % % %%% % % % % %  %%% %%%%%%%%%%%%%
% % %   % % % % % % %  %               %
% % %%% % % % % % % %  %  %%%%%%%%%%%%%%
% % % % % % % % % % %  %               %
% % % % % % % % % % %  %%%%%%%%%%%%%%%%%
%   %   % % % % % % %  %               %
%  %%%% % % % % % % %  %               %
%  %  % %       % % %  %               %
%  %  % %%%%%%%%% % %  %               %
%  %  % %         %    %               %
%  %  % %  %%%%%%%%%%%%%               %
%     % %  %           %               %
% %%%%% %  %  %%%%%%%% %         F     %
%     %                %               %
%%%%%%%%%%%%%%%%%%%%%%%%%%%%%%%%%%%%%%%%